"filename", "language", "Java", "comment", "blank", "total"
"c:\Users\cadel\OneDrive\Documents\ByteJam-Project\app\bin\main\bytejam\project\renderer\RenderBatch.class", "Java", -47, -19, 0, -66
"c:\Users\cadel\OneDrive\Documents\ByteJam-Project\app\bin\main\bytejam\project\renderer\Renderer.class", "Java", 25, 14, 0, 39
"c:\Users\cadel\OneDrive\Documents\ByteJam-Project\app\bin\main\bytejam\project\turbo\ExampleScene.class", "Java", -28, 0, 0, -28
"c:\Users\cadel\OneDrive\Documents\ByteJam-Project\app\bin\main\bytejam\project\turbo\PresentScene.class", "Java", -26, 0, 0, -26
"c:\Users\cadel\OneDrive\Documents\ByteJam-Project\app\bin\main\bytejam\project\turbo\Sound.class", "Java", -4, 0, 0, -4
"c:\Users\cadel\OneDrive\Documents\ByteJam-Project\app\bin\main\bytejam\project\turbo\TitleScene.class", "Java", -28, 0, 0, -28
"c:\Users\cadel\OneDrive\Documents\ByteJam-Project\app\bin\main\bytejam\project\turbo\Window.class", "Java", 3, 0, 0, 3
"c:\Users\cadel\OneDrive\Documents\ByteJam-Project\app\bin\main\bytejam\project\turbo\game_objects\Cursor.class", "Java", 1, 0, 0, 1
"c:\Users\cadel\OneDrive\Documents\ByteJam-Project\app\bin\main\bytejam\project\turbo\game_objects\Entity.class", "Java", 3, 0, 0, 3
"c:\Users\cadel\OneDrive\Documents\ByteJam-Project\app\bin\main\bytejam\project\turbo\game_objects\Projectile.class", "Java", 26, 0, 0, 26
"c:\Users\cadel\OneDrive\Documents\ByteJam-Project\app\bin\main\bytejam\project\turbo\game_scenes\CombatScene.class", "Java", 61, 0, 0, 61
"c:\Users\cadel\OneDrive\Documents\ByteJam-Project\app\bin\main\bytejam\project\turbo\game_scenes\EndScene.class", "Java", 31, 0, 0, 31
"c:\Users\cadel\OneDrive\Documents\ByteJam-Project\app\bin\main\bytejam\project\turbo\game_scenes\TitleScene.class", "Java", 27, 3, 0, 30
"c:\Users\cadel\OneDrive\Documents\ByteJam-Project\app\bin\main\bytejam\project\turbo\util\AI.class", "Java", -48, 0, 0, -48
"c:\Users\cadel\OneDrive\Documents\ByteJam-Project\app\bin\main\bytejam\project\turbo\util\Difficulty.class", "Java", -12, 0, 0, -12
"c:\Users\cadel\OneDrive\Documents\ByteJam-Project\app\bin\main\bytejam\project\turbo\util\EnemyManager.class", "Java", 63, 0, 0, 63
"c:\Users\cadel\OneDrive\Documents\ByteJam-Project\app\bin\main\bytejam\project\turbo\util\ProjectileManager.class", "Java", 32, 0, 0, 32
"c:\Users\cadel\OneDrive\Documents\ByteJam-Project\app\src\main\java\bytejam\project\renderer\RenderBatch.java", "Java", -205, -51, -75, -331
"c:\Users\cadel\OneDrive\Documents\ByteJam-Project\app\src\main\java\bytejam\project\renderer\Renderer.java", "Java", 132, 39, 49, 220
"c:\Users\cadel\OneDrive\Documents\ByteJam-Project\app\src\main\java\bytejam\project\renderer\Texture.java", "Java", -1, 0, 2, 1
"c:\Users\cadel\OneDrive\Documents\ByteJam-Project\app\src\main\java\bytejam\project\turbo\ExampleScene.java", "Java", -49, 0, -19, -68
"c:\Users\cadel\OneDrive\Documents\ByteJam-Project\app\src\main\java\bytejam\project\turbo\Scene.java", "Java", -2, 0, -3, -5
"c:\Users\cadel\OneDrive\Documents\ByteJam-Project\app\src\main\java\bytejam\project\turbo\Sound.java", "Java", -4, 1, -2, -5
"c:\Users\cadel\OneDrive\Documents\ByteJam-Project\app\src\main\java\bytejam\project\turbo\TitleScene.java", "Java", -26, -2, -16, -44
"c:\Users\cadel\OneDrive\Documents\ByteJam-Project\app\src\main\java\bytejam\project\turbo\Window.java", "Java", 8, 3, 3, 14
"c:\Users\cadel\OneDrive\Documents\ByteJam-Project\app\src\main\java\bytejam\project\turbo\gameScene.java", "Java", -89, -1, -24, -114
"c:\Users\cadel\OneDrive\Documents\ByteJam-Project\app\src\main\java\bytejam\project\turbo\game_objects\Cursor.java", "Java", 4, 0, 1, 5
"c:\Users\cadel\OneDrive\Documents\ByteJam-Project\app\src\main\java\bytejam\project\turbo\game_objects\Entity.java", "Java", 17, 0, 6, 23
"c:\Users\cadel\OneDrive\Documents\ByteJam-Project\app\src\main\java\bytejam\project\turbo\game_objects\Player.java", "Java", 0, -9, -1, -10
"c:\Users\cadel\OneDrive\Documents\ByteJam-Project\app\src\main\java\bytejam\project\turbo\game_objects\Projectile.java", "Java", 4, 0, 2, 6
"c:\Users\cadel\OneDrive\Documents\ByteJam-Project\app\src\main\java\bytejam\project\turbo\game_scenes\CombatScene.java", "Java", 155, 14, 58, 227
"c:\Users\cadel\OneDrive\Documents\ByteJam-Project\app\src\main\java\bytejam\project\turbo\game_scenes\EndScene.java", "Java", 40, 4, 12, 56
"c:\Users\cadel\OneDrive\Documents\ByteJam-Project\app\src\main\java\bytejam\project\turbo\game_scenes\TitleScene.java", "Java", 40, 4, 14, 58
"c:\Users\cadel\OneDrive\Documents\ByteJam-Project\app\src\main\java\bytejam\project\turbo\util\Difficulty.java", "Java", -3, 0, -3, -6
"c:\Users\cadel\OneDrive\Documents\ByteJam-Project\app\src\main\java\bytejam\project\turbo\util\EnemyManager.java", "Java", 3, 0, 4, 7
"c:\Users\cadel\OneDrive\Documents\ByteJam-Project\app\src\main\java\bytejam\project\turbo\util\ProjectileManager.java", "Java", 3, 0, 2, 5
"Total", "-", 106, 0, 10, 116